NO ../../resources/

SO ../../resources/

WE ../../resources/

EA ../../resources/

F 0,0,0

C 0,0,0


         111111111111
        10000000000001
        10000000000001
        10011111111001
       100001    100001
      10000001  10000001
      100000001100000000111
      1000000000000000000001
      1000000000000000000001
      1000000011000000001001
      10000001  100000011001
       100001    100001 1001
        1001      1001  1001
        1001      1001  1001
       100001    100001 1001
      10000001  100000011001
      1000000011000000001001
1111111000000000000000000001
1E00000000000000000000000001
111111100000001100000000111
      10000001  10000001
       100001    100001
        10011111111001
        10000000000001
        10000000000001
         111111111111