NO ./cub3D_std/resources/textures/letter_n.xpm

SO ./cub3D_std/resources/textures/letter_s.xpm

WE ./cub3D_std/resources/textures/letter_w.xpm

EA ./cub3D_std/resources/textures/letter_e.xpm

F 125,125,125

C 50,50,50

         111111111111
        10000000000001
        10011111111001
       100001    100001
      10000001  10000001
      10000000110000000011
      100000000000000000001
      100000000000000000001                 
      100000001100000000101      111 
      10000001  10000001101      101 
       100001    100001 101      111 
        1001      1001  101               
        1001      1001  101
       100001    100001 101
      10000001  10000001101
      100000001100000000101
111111100000000000000000001
1E0000000000000000000000001
11111110000000110000000011
      10000001  10000001
       100001    100001
        10011111111001
        10000000000001
         111111111111


         111111111111
         100000000001
         100000000001
         111111111111



                                                                         111111111111      
                                                                         100000000001    
                                                                         101111111001      
                                                                         101     1001     
                                                                         101111111001      
                                                                         100000000001        
                                                                         111111111111        
                                                                                              