NO ./cub3D_bonus/resources/textures/walls/pared1.xpm

SO ./cub3D_bonus/resources/textures/walls/pared2.xpm

WE ./cub3D_bonus/resources/textures/walls/pared3.xpm

EA ./cub3D_bonus/resources/textures/walls/pared4.xpm

F 13,3,1

C 1,1,1


1111111111111
1000000000001
1010101010101
1000000000001
10101D1D10101
1000D000D0001
101010N010101
1000D000D0001
10101D1D10101
1000000000001
1010101010101
1000000000001
1111111111111