NO ./cub3D_bonus/resources/textures/walls/prueba.xpm

SO ./cub3D_bonus/resources/textures/walls/prueba2.xpm

WE ./cub3D_bonus/resources/textures/walls/prueba3.xpm

EA ./cub3D_bonus/resources/textures/walls/prueba4.xpm

F 13,3,1

C 3,3,1


         111111111111
        1000D0000D0001
        10011111111001
       100001    100001
      10000001  10000001
      10000000110000000011
      100000000000000000001
      100000000000000000001
      100000001100000000101
      10000001  100000011D1
       100001    100001 101
        1001      1001  101         
        1001      1001  101
       100001    100001 101
      10000001  100000011D1
      100000001100000000101
111111100000000000000000001
1E0000D00000000000000000001
11111110000000110000000011
      10000001  10000001
       100001    100001
        10011111111001
        1000D0000D0001
         111111111111